R 1920 1080
NO ./textures/wall_1.xpm
SO ./textures/wall_2.xpm
WE ./textures/wall_3.xpm
EA ./textures/wall_4.xpm

S ./textures/sprite_1_barrel.xpm
F 150,75,0
C 0,150,210

        1111111111111111111111111
        1000000000110000000000001
        1011000001110000002000001
        1001000000200000000200001
111111111011020001110000002000001
100022000011002001110111111111111
11110111111111011100000010001
11110111111111011101010010001
11200020110101011100000010201
1000000200100001100000010201
1000E000020002001101010010201
11220001110101011111011110101
11110111 1110101 101111010001
11111111 1111111 111111111111